NO textures/star_wars/star_wars_wall_north.xpm
SO textures/star_wars/star_wars_wall_south.xpm
WE textures/star_wars/star_wars_wall_west.xpm
EA textures/star_wars/star_wars_wall_east.xpm


F 44,44,43
C 33,33,23


1111
1E01
1001
1111