NO textures/star_wars/star_wars_wall_north.xpm
SO textures/star_wars/star_wars_wall_south.xpm
WE textures/star_wars/star_wars_wall_west.xpm
EA textures/star_wars/star_wars_wall_east.xpm
F 44,44,43

        1111111111111111111111111
C 33,33,23
        1000000000110000000000001
        1011000001110000000000001
        1001000000000000000000001
111111111011000001110000000000001
100000000011000001110111111111111
11110111111111011100000010001
11110111111111011101010010001
11000000110101011100000010001
10000000000000001100W00010001
10000000000000001101010010001
110000011101010111110111100011
11110111 1110101 1011110100011
11111111 1111111 1111111111111