111111
100101
101001
1100N1
111111

1111111
1000001
1000001
100E001
1000001
1000001
1111111
